1111111111111
1100000C10001
1000P00000011
10C0111001001
1000111000011
10E0111000011
100C000000E01
1111111111111